+---+---+---+---+---+---+---+---+---+---+---+---+---+---+---+---+
|   |   |   |   |   |   |   |   |   |   |   |   |   |   |   |   |
+---+---+---+---+---+---+---+---+---+---+---+---+---+---+---+---+
|   |   |   |   |   |   |   |   |   |   |   |   |   |   |   |   |
+---+---+---+---+---+---+---+---+---+---+---+---+---+---+---+---+
|   |   |   |   |   |   |   |   |   |   |   |   |   |   |   |   |
+---+---+---+---+---+---+---+---+---+---+---+---+---+---+---+---+
|   |   |   |   |   |   |   |   |   |   |   |   |   |   |   |   |
+---+---+---+---+---+---+---+---+---+---+---+---+---+---+---+---+
|   |   |   |   |   |   |   |   |   |   |   |   |   |   |   |   |
+---+---+---+---+---+---+---+---+---+---+---+---+---+---+---+---+
|   |   |   |   |   |   |   |   |   |   |   |   |   |   |   |   |
+---+---+---+---+---+---+---+---+---+---+---+---+---+---+---+---+
|   |   |   |   |   |   |   |   |   |   |   |   |   |   |   |   |
+---+---+---+---+---+---+---+---+---+---+---+---+---+---+---+---+
|   |   |   |   |   |   |   | @   @                             |
+---+---+---+---+---+---+---+   +   +   +---+---+---+---+---+   +
|   |   |   |   |   |   |   | @   @ |       |   |   |   |   |   |
+---+---+---+---+---+---+---+---+---+---+   +---+---+---+---+   +
|   |   |   |   |   |   |   |   |   |   |   |   |   |   |   |   |
+---+---+---+---+---+---+---+---+---+---+   +---+---+---+---+   +
|   |   |   |   |   |   |   |   |   |   |   |   |   |   |   |   |
+---+---+---+---+---+---+---+---+---+---+   +---+---+---+---+   +
|   |   |   |   |   |   |   |   |   |   |           |   |   |   |
+---+---+---+---+---+---+---+---+---+---+---+---+   +---+---+   +
|   |   |   |   |   |   |   |   |   |   |   |   |   |   |   |   |
+---+---+---+---+---+---+---+---+---+---+---+---+   +---+---+   +
|   |   |   |   |   |   |   |   |   |   |   |   |           |   |
+---+---+---+---+---+---+---+---+---+---+---+---+---+---+   +   +
|   |   |   |   |   |   |   |   |   |   |   |   |   |   |   |   |
+---+---+---+---+---+---+---+---+---+---+---+---+---+---+   +   +
| S                                                             |
+---+---+---+---+---+---+---+---+---+---+---+---+---+---+---+---+
