+---+---+---+---+---+---+---+---+---+---+---+---+---+---+---+---+
|                   |   |   |   |   |   |   |   |   |   |   |   |
+   +---+---+---+   +---+---+---+---+---+---+---+---+---+---+---+
|   |           |   |   |   |   |   |   |   |   |   |   |   |   |
+   +   +   +   +   +---+---+---+---+---+---+---+---+---+---+---+
|   |   |   |   |   |   |   |   |   |   |   |   |   |   |   |   |
+   +   +   +   +   +---+---+---+---+---+---+---+---+---+---+---+
|   |       |   |   |   |   |   |   |   |   |   |   |   |   |   |
+   +   +   +   +   +---+---+---+---+---+---+---+---+---+---+---+
|   |   |       |   |   |   |   |   |   |   |   |   |   |   |   |
+   +   +   +   +   +---+---+---+---+---+---+---+---+---+---+---+
|   |   |   |   |   |   |   |   |   |   |   |   |   |   |   |   |
+   +---+   +---+   +---+---+---+---+---+---+---+---+---+---+---+
|   |       |                           |   |   |   |   |   |   |
+   +---+   +   +   +---+---+---+---+   +---+---+---+---+---+---+
|   |   |   |   |   |   |   | @   @                             |
+   +   +   +   +   +   +   +   +   +   +---+---+---+---+---+   +
|   |       |   |   |   |   | @   @ |       |   |   |   |   |   |
+   +---+   +   +   +   +   +---+---+---+   +---+---+---+---+   +
|   |           |   |   |               |   |   |   |   |   |   |
+   +   +   +   +   +   +---+   +---+---+   +---+---+---+---+   +
|   |   |   |   |   |   |   |   |       |   |   |   |   |   |   |
+   +   +---+---+   +   +   +   +---+   +   +---+---+---+---+---+
|   |           |       |               |           |   |   |   |
+   +   +---+   +---+---+---+   +---+---+---+---+   +---+---+   +
|   |   |                                       |   |   |   |   |
+   +   +---+---+---+---+---+---+---+---+---+---+   +---+---+   +
|   |                                           |           |   |
+   +---+---+---+---+---+---+---+---+---+---+---+---+---+   +   +
|       |                                                   |   |
+---+   +---+---+---+---+---+---+---+---+---+---+---+---+   +   +
| S                                                             |
+---+---+---+---+---+---+---+---+---+---+---+---+---+---+---+---+
