+---+---+---+
|       |   |
+   +   +   +
|   |       |
+---+---+---+
