+---+---+---+---+---+
|   |               |
+   +   +---+   +---+
|   |   |   |       |
+   +   +   +   +   +
|               |   |
+   +---+   +   +   +
|   |       |       |
+   +---+---+---+   +
|   |               |
+---+---+---+---+---+
