+---+---+---+---+---+
|   |               |
+   +   +---+   +---+
|   |       |       |
+   +   +---+   +   +
|               |   |
+   +---+   +   +   +
|   |       |       |
+   +---+---+---+   +
|   |               |
+---+---+---+---+---+
