+---+---+---+---+---+---+---+---+---+---+---+---+---+---+---+---+
|   |                                                           |
+   +   +   +---+---+---+---+---+---+---+---+---+---+   +   +---+
|       |   |               |               |       |   |       |
+   +---+   +   +---+---+   +   +---+---+   +   +   +---+---+   +
|           |   |       |       |       |       |           |   |
+   +---+   +   +   +   +---+---+   +   +---+---+---+---+   +   +
|           |       |               |               |       |   |
+   +---+---+---+---+---+---+---+---+---+---+---+   +   +---+   +
|   |       |       |           |           |       |       |   |
+   +   +   +   +   +   +   +   +   +   +   +   +---+---+   +   +
|   |   |       |       |   |       |   |       |           |   |
+   +   +---+---+---+---+---+---+---+---+---+---+---+   +---+   +
|   |       |           |               |       |           |   |
+   +---+   +   +   +---+   +   +---+   +   +   +---+   +---+   +
|   |       |   |       |   | @   @ |       |               |   |
+   +   +---+   +---+   +   +   +   +---+---+---+---+   +---+   +
|   |   |       |       |   | @   @ |   |                   |   |
+   +   +   +---+   +---+   +---+---+   +   +   +---+---+---+   +
|   |       |           |                   |               |   |
+   +---+---+   +---+---+---+---+---+---+---+---+---+---+   +   +
|   |           |       |   |       |   |           |       |   |
+   +   +---+---+   +   +   +   +   +   +   +   +---+   +---+   +
|   |       |       |           |           |   |   |       |   |
+   +---+   +   +---+---+   +---+---+   +---+   +   +---+   +   +
|   |       |       |   |   |       |   |       |           |   |
+   +   +---+---+   +   +---+   +   +---+   +---+   +---+---+   +
|   |   |           |           |           |   |   |           |
+   +   +   +---+---+   +---+---+---+---+---+   +   +   +   +   +
|       |   |   |   |                               |   |   |   |
+   +---+   +   +   +---+---+---+---+---+---+---+---+---+---+   +
| S |                                                           |
+---+---+---+---+---+---+---+---+---+---+---+---+---+---+---+---+
