+---+---+---+---+---+
|   |               |
+   +   +---+---+---+
|       |           |
+   +---+   +---+   +
|               |   |
+---+   +---+   +   +
|       |       |   |
+   +---+---+---+   +
|                   |
+---+---+---+---+---+
