+---+---+---+---+---+
|   |               |
+   +   +---+---+---+
|   |   |           |
+   +---+   +---+   +
|   |       |   |   |
+---+   +---+---+   +
|       |   |   |   |
+   +---+---+---+   +
|                   |
+---+---+---+---+---+
