+---+---+---+---+---+---+---+---+---+---+---+---+---+---+---+---+
|                                                               |
+   +---+---+   +---+---+---+---+---+---+---+   +---+---+---+   +
|               |                                           |   |
+   +---+---+   +   +---+---+---+   +   +---+   +   +---+---+   +
|           |   |   |           |   |       |   |   |           |
+---+   +---+   +---+   +---+   +   +   +---+   +   +---+   +   +
|                   |       |       |   |                   |   |
+---+---+---+   +   +---+---+   +---+   +---+---+   +   +   +   +
|   |           |           |   |   |   |           |   |   |   |
+   +---+---+   +---+---+   +   +   +   +   +---+   +   +   +   +
|   |                       |   |       |       |   |   |       |
+   +   +---+---+   +---+---+---+   +   +---+   +   +   +   +   +
|                       |           |   |       |   |   |   |   |
+   +---+---+---+---+---+   +---+---+   +   +---+   +   +   +   +
|                       |   |       |   |   |   |       |   |   |
+   +---+---+---+---+---+   +   +   +   +   +   +---+---+   +   +
|                       |           |   |           |   |   |   |
+   +---+---+---+---+---+---+---+---+   +   +---+---+   +   +   +
|                           |   |   |   |   |   |       |       |
+---+---+   +---+   +---+---+   +   +   +   +   +   +   +   +   +
|                   |           |   |   |   |   |   |   |   |   |
+   +---+---+---+---+   +---+   +   +   +   +   +   +   +   +   +
|               |       |       |   |   |   |       |   |   |   |
+---+   +   +   +   +   +---+   +   +   +   +   +   +   +   +   +
|       |   |   |   |           |   |       |   |           |   |
+---+   +   +   +   +   +---+   +   +---+---+   +   +   +   +   +
|       |   |           |   |   |   |   |           |   |   |   |
+   +---+   +   +   +   +   +   +   +   +   +   +   +   +   +   +
|           |   |   |   |   |   |   |   |   |   |   |   |       |
+---+---+   +   +   +   +   +   +   +   +   +---+---+---+   +   +
|               |   |       |                           |   |   |
+---+---+---+---+---+---+---+---+---+---+---+---+---+---+---+---+
