+---+---+---+---+---+
|   |               |
+   +   +---+   +---+
|   |       |       |
+   +---+---+   +   +
|               |   |
+   +---+   +   +   +
|   |       |       |
+   +---+---+---+   +
|   |               |
+---+---+---+---+---+
