+---+---+---+---+---+---+---+---+
|                           |   |
+   +---+   +---+---+   +   +   +
|   |   |   |       |   |       |
+   +   +   +   +   +   +   +   +
|       |   |   |       |   |   |
+---+   +   +---+   +---+   +   +
|           |       |       |   |
+   +---+---+   +   +   +---+   +
|           |       |       |   |
+---+   +   +---+---+---+   +   +
|       |       |           |   |
+   +---+   +   +   +---+   +   +
|           |   |   |           |
+---+---+   +   +   +---+---+   +
|           |               |   |
+---+---+---+---+---+---+---+---+
